|                                                                                                                                                                                                                               |
|                                                                                                                                                                                                                               |
|                                                                                                                                                                                                                               |
|                                                                                                                                                                                                                               |
|                                                                                                                                                                                                                               |
|                                                                                                                                                                                                                               |
|                                                                                                                                                                                                                               |
|                                                                                                                                                                                                                               |
|                                                                                                                                                                                                                               |
|                                                                                                                                                                                                                               |
|           ---                                                                                                                                                                                                                 |
|                                                                                                                                                                                                                               |
|                                                                                                                                                                                                                               |
|    x                     |                                                                                                                                                                                                     |
|||||||||||||||||||||   |||||||||||||||||||||||||||||||||||||||||||||||||||||||||||||||||||||||||||||||||||||||||||||||||||||||||||||||||||||||||||||||||||||||||||||||||||||||||||||||||||||||||||||||||||||||||||||||||||||||||